1111111111111
1P01000000001
100C011111001
100E111000001
1111111111111
